&0000...0000&
&0000eee0000&
&l00wvvvwwww&
&.....^.....&
&...........&
&...........&
&...........&
he..d.d.d...x
he..........x
he..d.d.d...x
&...........&
&...........&
&...........&
&.....^.....&
&&&&&xxx&&&&&
