&0000...0000&
&0000eee0000&
&l00wvvvwwww&
&...........&
&..^........&
&.....ddd...&
&.......d...&
he......d...x
he..........x
he....d.....x
&.....d.....&
&.....ddd...&
&........^..&
&...........&
&&&&&xxx&&&&&
