&0000...0000&
&0000eee0000&
&l00wvvvwwww&
&...........&
&...........&
&...d.d.d...&
&.........^.&
he..d.d.d...x
he..........x
he..d.d.d...x
&.........^.&
&...d.d.d...&
&...........&
&...........&
&&&&&xxx&&&&&
