#####vvv#####
&....eee....&
&...........&
&...........&
&...........&
he..........x
he..........x
he..........x
&...........&
&...........&
&...........&
&...........&
&&&&&xxx&&&&&
