&0000...0000&
&0000eee0000&
&l00wvvvwwww&
&...........&
&...........&
&...........&
&...........&
he..........x
he..........x
he..........x
&...........&
&...........&
&...........&
&...........&
&&&&&xxx&&&&&
