&0000...0000&
&0000eee0000&
&l00wvvvwwww&
&...........&
&.........^.&
&...ddddd...&
&...........&
he..........x
he..........x
he..........x
&...........&
&...ddddd...&
&.........^.&
&...........&
&&&&&xxx&&&&&
