&0000...0000&
&0000eee0000&
&l00wvvvwwww&
&...........&
&...........&
&.....d.....&
&.........^.&
he....d.....x
he..........x
he....d.....x
&.........^.&
&.....d.....&
&...........&
&...........&
&&&&&xxx&&&&&
