&0000...0000&
&0000eee0000&
&l00wvvvwwww&
&...........&
&.....^.....&
&...........&
&...d...d...&
he..d...d...x
he..d...d...x
he..d...d...x
&...d...d...&
&...........&
&.....^.....&
&...........&
&&&&&xxx&&&&&
