&0000...0000&
&0000eee0000&
&l00wvvvwwww&
&...........&
&...dd.dd...&
&.........^.&
&...dd.dd...&
he..........x
he..dd.dd...x
he..........x
&...dd.dd...&
&.........^.&
&...dd.dd...&
&...........&
&&&&&xxx&&&&&
