################
&..............&
&..............&
&..............&
&...............
&...............
&...............
&..............&
&..............&
&..............&
&&&&&&&&&&&&&&&&
